0000000000000000000000000
0c000000c000c00000000c000
0000c0000000000000c000000
0c0000000c00000c00000c000
00000c00000c0000000c00000
00c00000c000000c000000c00
0000000000000000000000000
0000000000000000000000000
wwww0000000000000000wwwww
0000000000000000000000000
0000000wwwwwwwwwww0000000
0000000000000000000000000
0000000000000000000000000
0000000000000000000000000
0000000000000000000000000